{
  "tilemap":[
    [1,1,1,1,1,1,8,8,8,1,1,1,1,1,1],
    [1,5,5,5,6,0,0,0,0,0,0,0,0,0,1],
    [1,5,5,5,1,1,1,1,1,1,1,1,1,0,1],
    [1,5,5,5,0,0,0,0,0,0,0,0,1,0,1],
    [1,0,0,0,0,0,0,0,0,0,0,0,1,0,1],
    [1,1,1,0,0,0,0,0,0,0,0,0,1,0,1],
    [8,0,1,0,0,0,0,0,0,0,0,0,1,0,8],
    [8,0,1,4,4,4,4,4,4,4,4,4,1,0,8],
    [8,0,0,0,0,0,0,0,0,0,0,0,0,0,8],
    [1,0,0,0,0,0,0,0,0,0,0,0,0,0,1],
    [1,0,0,0,0,0,0,3,0,3,0,3,0,0,1],
    [1,0,4,4,0,0,0,3,0,3,0,3,0,0,1],
    [1,0,4,4,0,0,0,3,0,3,0,3,0,0,1],
    [1,0,0,0,0,0,0,0,0,0,0,0,0,0,1],
    [1,1,1,1,1,1,8,8,8,1,1,1,1,1,1]
  ],
  "specialtilemap":[
    [0,0,0,0,0,0,0,0,0,0,0,0,0,0,0],
    [0,0,0,0,0,0,0,0,0,0,0,0,0,0,0],
    [0,0,0,0,0,0,0,0,0,0,0,0,0,0,0],
    [0,0,0,0,0,0,0,0,0,0,0,0,0,0,0],
    [0,0,0,0,0,0,0,0,0,0,0,0,0,0,0],
    [0,0,0,0,0,0,0,0,0,0,0,0,0,0,0],
    [0,0,0,0,0,0,0,0,0,0,0,0,0,0,0],
    [0,0,0,0,0,0,0,0,0,0,0,0,0,0,0],
    [0,0,0,0,0,0,0,0,0,0,0,0,0,0,0],
    [0,0,0,0,0,0,0,0,0,0,0,0,0,0,0],
    [0,0,0,0,0,0,0,0,0,0,0,0,0,0,0],
    [0,0,0,0,0,0,0,0,0,0,0,0,0,0,0],
    [0,0,0,0,0,0,0,0,0,0,0,0,0,0,0],
    [0,0,0,0,0,0,0,0,0,0,0,0,0,0,0],
    [0,0,0,0,0,0,0,0,0,0,0,0,0,0,0]
  ],
  "rotates":true
}